@reignmaster		ReignFC, USWNT, Women’s Soccer, OneNote	178
@eboybarrow	Umeå, Sverige	Hasbunallah wanehmal wakeel #BarhamaNiass4Ever #EpidemiologyandGlobalHealth #UISPH @UmeåUniversity  #PublicHealthOfficial	1552
@DucksInnaRow	OKC, Oklahoma, USA 🇺🇸	Retired Licensed Clinical Social Worker (MSW, LCSW). Univ of OK & Norfolk State Univ, VA graduate.	783
@kiddchrisina			643
@richoneill282	Nottingham	NFFC. Notts CCC and England Cricket. Love Snooker. Animal lover. Despise Hunters and Poachers!  Anti-Lockdowns.	1750
@InstitutoBalmis	Almería, Spain	Asociación científica sin ánimo de lucro para la promoción de la formación, la investigación y la cooperación internacional de las vacunas y la inmunización.	1879
@Dalyox3			22
@ACalmRainStorm	She/Her	transfem, socialist, gamer	306
@SusanKarpatkin			149
@DebErupts	California	Nursing & Law, RN, JD. Healthcare for All! Badass believer in human rights. Army Brat. Artist. Gardener. Tweets are my own, especially offensive ones. 🌊	4045
@musicboxonline	Oak Park, Illinois	Exploring the World of Music	573
@WeBeHealthy	Thompsonville, MI	I am a Health Strategist dedicated to helping you in Your Journey to Heal and Be Healthy…this is my passion.	1211
@apachendeh	Oregon, USA	Native American-Aboriginal Rights Defender-cancer survivor-naturalist-activist-The Resistance-Anti Fascist-BLM! Born in the Fall	4233
@_ScarlettYang		PhD Student | Penn Immunology | Regulatory Science | UC Berkeley alum	156
@susikabusi	London, England	Read, Write, Speak, Repeat.	529
@_BlackMzungu	Utopia 	☮ Unorthodox ☮ World Citizen ☮	6668
@emilia_jesmer	Upstate, New York	🧚‍♀️sixties child..daughter, sister, mom, nana✨lover of my husband, nature, music, Jin shin jyutsu healing touch, freedom & peace🌊🇺🇸🌊🇺🇸🌊🇺🇸🌊🇺🇸	1726
@sagetwitting		so my popular culture references and ponderings may be a few years out of date. or decades. close enough.	2814
@Lmhaydu	South Florida	Wife, mom, animal rescuer, marketing pro, obsessive proofreader, UF Grad & Gator fan, proud Democrat and believer in racial equality. #getvaccinated	580
@slidewinding	🏳️‍🌈 LGBTQ 🏳️‍🌈 Embrace Diversity 🏳️‍🌈	"Elements Of Medical"👩🏽‍⚕️⛑️ Like Schrodinger's Immigrant: In 2 quantum states at once Semper Ciencias🔬☣️👩🏽‍🔬  🤟🏽ASL  🥋🇺🇦🌻	2825
@Cinderoak	Virginia, USA	we do not own the earth we borrow it from our children. #BLM #ClimateChangeIsReal. #VotingRightsNow Lock trump Up. #LGBTQ 🌊	6768
@kthomason	Waterloo, Ontario		646
@soulcityusa	Memphis | Tempe	#PrayForUkraine #StandWithUkraine  F*ck Iggy. F*ck Shams. Go Grizz.	1135
@KarenHempel71	Wisconsin 	Mom, grandma, retired special education teacher. #Biden/Harris. Vote! No DM.	1328
@jennywackett	Somewhere	Funny mummy. Editor and writer. And, according to Piers Morgan, #ARabidFeminist  #JohnsonOut	2198
@Forslund2000	Kansas City, KS	A middle of the road guy who lives in KC. Wouldn’t it be nice if people would think before they Speak/Tweet! NeverTrumper	79
@Shordievali	HappilyInSolitaryConfinement	Noire🙎🏾‍♀️ 666	469
@sustainbytrain	stolen land 	she/her Everything is connected. Fighting 4 circular, justice & resource based economy NOW. #womeninconstruction anonymous bc current harraser	452
@levinho1904		Für echte soziale Marktwirtschaft. Gesundheit ist das höchste Gut. LongCovid ist Realität. Familienvater.	343
@Maddygram	Tir-tairngireadh,Cork, Ireland	Fighting Chavismo/ Trumpismo one red at a time! Proud descendant of nits that so thoroughly vexed Cromwell!Laughing Celt R1b-P312	3630
@kohyarp	Earth	Do unto others as you would have others do unto you #HopesAllWeHave #FightForFairness	70
@larn247	cats	trying my best (they/them, 24) 🍋: @shygybeats check out my linktree for tarot & art content! ♐️☀️♋️🌙♎️🌅	135
@DanielleLarivee	Slave Lake, AB	First VP, United Nurses of Alberta. RN. Former MLA for Lesser Slave Lake and AB Cabinet Minister. MBA Student. Mom of three. LetsGoOilers! She/Her/Hers	6981
@anniemmm	born in the shadow of pike's peak	misanthropic anthropologist USAF vet	1041
@LCkindness6	Here and Now	She/her	265
@kdseekerjust		Total tree hugger, lover of beauty in nature. I want sanity, decency, equality, inclusion and dignity back in our country. NO MAGA cultists or Megexit gang.	2733
@Rocky1542	North Dakota	Somehow not surprised to be watching the traitors in the cult of trump aka the GQP cheer for Putin invading a sovereign country without provocation. Vote Blue!	11471
@DoubleFugee	Canada	Dad, Entrepreneur, USSR born, Canadian refugee/expat in Mexico.	58
@tsukihomie		25 PRE FRONTAL COMPLETE 🇬🇾 ♍ Virgo, Scholarly Anime Trash. Social Activist. Black, Diligent and Unapologetic with the truth. He/Him/His	306
@Rahimli_Laman	Cologne, Germany	Research associate in University Hospital of Cologne	80
@MuslimTrumpSad		"When push comes to shove, I will kill your friends and family to remind you of my love." -King George III   **Trump is going to prison. Mark it, dude. Mark it.	1786
@ShirleyFinkles1	Ohio, USA	I'm a retired grandmother, advocate for individuals with disabilities, animal lover, self-renovating my house inch-by-inch: power tools are my play toys...	350
@magicagi		Mask-wearing, science-believing, part of Resistance, 🇵🇱🤝🇺🇦	38
@MrsPerrin		~Conservative ~Former Law Enforcement ~Producer,"Seal of Saimaa"  ~Animal Rehab / transport ~Biz Owner ~CCW ~Navy #Vet Wife ⚓ Indy ProLife Italian American	3633
@TeachYoungChild		Teacher, professor, child development specialist, literacy specialist, speech/language pathologist, psycholinguist, activist, advocate, dog mom-ENTJ	111
@ValMackinnon	Unama’ki, Canada	Anti-Racist. Grandmother. She/Her.  Peace and Friendship Treaty  #MeToo. #BlackLivesMatter	3704
@sunni35		#TheResistance	1570
@MaryMarybrogdon	Spring Shadows, Houston	So the darkness shall be the light, and the stillness the dancing. T.S.Eliot	3689
@Jthehutt2			80
@ellescott1	San Francisco	Political Scientist in past life| Realtor in reality| Mom, sister, friend| search for humor in the everyday|world traveler and baseball enthusiast	841
@British23523007	Londonderry, Northern Ireland	Proud to be British🇬🇧 Social Liberalist💥 Lib Dem Politics. History Undergrad Stu. Supporter of GB News.	498
@Macsmart31		Return decency, integrity, and leadership to White House. Democracy is at stake!  ( And I took snowy owl photo myself!😁) #WomanAgainstTrump NO DM's please.	5607
@MErovich1	Wonderland	What current events remind you of the history of the first half of 20th century?	204
@Stormbelle35	Ontario, Canada		167
@LNnop	Topeka, Kansas	Only useless things, be they facts or skills.	183
@thedoggeneral1	Illinois, USA	Personal Trainer, Black🥋Belt, Bodybuilder (58yr-old w/aches) Daughter & Dog. #TheResistance #ChicagoCubs	12509
@jellencamara		Lawyer, Writer, Educator. Feminist since 1972. Three smart granddaughters = future.	73
@SherryC56891871	Kentucky, USA	Retired horse person.	181
@Mikebespeckled		Political science major and political nerd. Pats fan, passionate, and pragmatist.	497
@Neon_H_Newton	xy 		796
@lynn180_lynn	Oregon, USA	Interested in smart credible information. vaccinated, ☕️ tea coffee, 🌳hugging mom, ✡️, atheist, 🎨, ✌🏼, spelling challenged, occasionally funny. -Support 🇺🇦	534
@DHaveson		Didn't realize I have been on this thing since 2015! Democrat - for whatever that's worth Stop blaming ignorance for what is clearly just stupidity.	19
@kchr_grr_krch__	Deutschland	#NoCovid #ZeroCovid #BildungAberSicher - für Schule MIT INFEKTIONSSCHUTZ - Hybridunterricht, Masken, Abstand, (Schnell)tests  -- Schwurbler werden geblockt. --	1371
@dirieone7073			948
@katisnotakat	United States		321
@1970LizzieM		Mother•Grandmother•Family's Everything•The Arts•#Insulin4All• #Type1DiabetesAwarenessMatters• #CureT1D•#MurderMystery2• #ThePlane•#KingRichard• #HotZoneAnthrax	784
@JeanneBeesBuzz	Missouri, USA	Curious, love to laugh, serious when necessary. Life lessons strategy. Observant. Questioning, which brings us back to curious.	283
@sheeda418	Los Angeles, CA	Writer: Baking/First Xmas, Fatal Affair. #KHive #Resist, 💜💛, UCLA 💙💛, #GoDodgers 💙, ⚜️🐏🏈. Prov. 3:5: Trust the Lord. My opinion. she/her	1873
@JudyWhat34		Not taking it anymore.	568
@ShelbyClaybourn	Newburgh, IN	Mother, daughter, lawyer, Hoosier, Castle Knight, champion of fairness, empathy & equality, & Newburgh Town Councilor.	504
@peaceisntprtisn	Pacific Northwest 🌲🌲		79
@jacirez	Alberta, Canada	I'm a Software Engineer, Composer, Writer & Private Researcher in NW AB, Canada. Follow on #YouTube https://t.co/gzGob7gNLv	91
@Do_Good_Stuff		Advocate | Changemaker | Proud🇨🇦 Making it count every day w grace & persistence. No patience for stupidity. No tolerance for ignorance. ~Tweets are mine	410
@deutschelady	New Jersey, USA	mother, wife, scientist, educated, formerly scared,now hopeful for her adopted country, liking to be able to breathe again	2278
@maureenshea11	Northern CA	Anthropology, Org  Development.  Ret. many careers: Board Chair, Consultant,  Project Mgr.  Sales Mgr.  ER admissions 2 decades. mental health worker	189
@PatriciaSomer11	South London	#JohnsonOut  Atheist   Labour Party member	2239
@phillipgreenii	Pittsburgh, PA	🥔 | he/him	61
@CALANNSHE	Manchester		641
@janeintravel	Somerset UK	Ardent #covidiots #antivaxxers #climatechange deniers blocked as selfishness tends to be their common denominator.	132
@TheSpeedSnail	The Boona Tuna Can	Artist who believes in the power of science, tech, the arts. I follow the money. Progressive Dem. VoteBlue Save the Planet MedicareForAll	510
@SusanChubb1		cancer survivor, UK Govt response to Covid19UK breaks EUCHR Article 2 Failure to Protect. thoughts & opinions are my own.#JOHNSONOUT	7574
@canadian_stix	Canada	The sword of justice has no scabbard	366
@vanessatoal	Coldstream, British Columbia	Mother, Registered Veterinary Technologist, Thompson Rivers University - Open Learning. 💙💛	472
@TVuk25	Los Angeles, CA	mom, feminist, supporter of the Meidas Touch and Fair Fight	136
@TamaraCostas3	Florida, USA	Democrat, Mah Jongg is my thing! Vote 🗳 BLUE in 2022!	444
@harrietscontest			52
@Chris_F_Carson	Australia	microbiologist phd science communicator passionate about research funding views very much my own	566
@JoseLaquidain		Curious and eager to learn. Constructive dialog is the goal, when/if possible. Science is the best tool we have to prevent our self-annihilation.	1037
@hotboyriah		new acc// hottielamb jaden stan💜💙💛// gamer & dc/marvel nerd 😁 // athabaskan	151
@microbekween	Unceded lək̓ʷəŋən territory	The Girl With the Yeast Tattoo : trans rights = human rights	63
@sarahr1515	Dorset UK	Nurse, Wife, Mother, Geek, Feminist. All views my own	267
